+--+--+--+--+
|p    |     |
+  +--+--+  +
|           |
+--+  +--+  +
|     |  |  |
+  +  +  +--+
|  |       g|
+--+--+--+--+