+--+--+--+--+
p           |
+  +--+  +  +
|  |     |  |
+  +  +--+--+
|  |        |
+  +--+--+  +
|        |  g
+--+--+--+--+